%%%%%%%%%%%%%%%%%%%%
%......%G  G%......%12
%.%%...%%  %%...%%.%8
%.%o.%........%.o%.%4
%.%%.%.%%%%%%.%.%%.%6
%........P.........%16
%%%%%%%%%%%%%%%%%%%%
